Noah	Lucas
Liam	Jackson
Mason	David
Jacob	Oliver
William	Emma
Ethan	Olivia
Mason	James
James	Sophia
Alexander	Ava
Michael	Isabella
Benjamin	Mia
Elijah	Abigail
Daniel	Lucas
Aiden	Jackson
Logan	David
Matthew	Oliver
Lucas	Emma
Jackson	Olivia
David	Sophia
Oliver	Ava
Emma	Isabella
Olivia	Mia
Sophia	Abigail
Ava		Lucas
Isabella	Jackson
Mia	David
Abigail	Oliver
Emily	Emma
Charlotte	Olivia
Harper	Mason
Harper	Sophia
Madison	Ava
Amelia	Isabella
Logan	Michael
Chloe	Michael
Elizabeth	Mia
Sofia	Abigail
Evelyn	Lucas
Avery	Jackson
Chloe	David
Ella	Oliver
Grace	Emma
