Eliana	Sloane
Sophie	Kamila
London	Lia
Elena	Haven
Kimberly	Rowan
Bailey	Ashlyn
Maria	Christina
Luna	Amber
Willow	Myla
Jasmine	Addilyn
Kinsley	Erin
Valentina	Alison
Kayla	Ainsley
Delilah	Raelyn
Andrea	Cadence
Natalia	Kendra
Lauren	Heidi
Morgan	Kelsey
Rylee	Nadia
Sydney	Alondra
Adalynn	Cheyenne
Mary	Kaydence
Ximena	Mikayla
Jade	River
Liliana	Heaven
Brielle	Arielle
Ivy	Lana
Trinity	Blakely
Josephine	Sabrina
Adalyn	Kyla
Jocelyn	Ada
Emery	Gracelyn
Adeline	Allyson
Jordyn	Felicity
Ariel	Kira
Everly	Cameron
Lilly	Josiah
Paige	Adrian
Isla	Colton
Lyla	Jordan
Makayla	Brayden
Molly	Nicholas
Emilia	Robert
Mya	Angel
Kendall	Hudson
Melody	Lincoln
Isabel	Evan
Brooke	Dominic
Mckenzie	Austin
Nicole	Gavin
Payton	Nolan
Margaret	Parker
Mariah	Adam
Eden	Chase
Athena	Jace
Amy	Ian
Norah	Cooper
Londyn	Easton
Valeria	Kevin
Sara	Jose
Aliyah	Tyler
Angelina	Brandon
Gracie	Asher
Rose	Jaxson
Rachel	Mateo
Juliana	Jason
Laila	Ayden
Brooklynn	Zachary
Valerie	Carson
Alina	Xavier
Reese	Leo
Elise	Ezra
Eliza	Bentley
Alaina	Sawyer
Raelynn	Sloane
Leilani	Kamila
Catherine	Lia
Emerson	Haven
Cecilia	Rowan
Genevieve	Ashlyn
Daisy	Christina
Harmony	Amber
Vanessa	Myla
Adriana	Addilyn
Presley	Erin
Rebecca	Alison
Destiny	Ainsley
Hayden	Raelyn
Julianna	Cadence
Michelle	Kendra
Adelyn	Heidi
Arabella	Kelsey
Summer	Nadia
Callie	Alondra
Kaitlyn	Cheyenne
Ryleigh	Kaydence
Lila	Mikayla
Daniela	River
Arya	Heaven
Alana	Arielle
Esther	Lana
Finley	Blakely
Gabrielle	Sabrina
Jessica	Kyla
Charlie	Ada
Stephanie	Gracelyn
Tessa	Allyson
Makenzie	Felicity
Ana	Kira
Amaya	Cameron
Alexandria	Josiah
Alivia	Adrian
Nova	Colton
Anastasia	Jordan
Iris	Brayden
Marley	Nicholas
Fiona	Robert
Angela	Angel
Giselle	Hudson
Kate	Lincoln
Alayna	Evan
Lola	Dominic
Lucia	Austin
Juliette	Gavin
Parker	Nolan
Teagan	Parker
Sienna	Adam
Georgia	Chase
Hope	Jace
Cali	Ian
Vivienne	Cooper
Izabella	Easton
Kinley	Kevin
Daleyza	Jose
Kylee	Tyler
Jayla	Brandon
Katelyn	Asher
Juliet	Jaxson
Maggie	Mateo
Dakota	Jason
Delaney	Ayden
Brynlee	Zachary
Keira	Carson
Camille	Xavier
Leila	Leo
Mckenna	Ezra
Aniyah	Bentley
Noelle	Sawyer
Josie	Kayden
Jennifer	Sloane
Melissa	Kamila
Gabriela	Lia
Allie	Haven
Eloise	Rowan
Cassidy	Ashlyn
Jacqueline	Christina
Brynn	Amber
Sawyer	Myla
Evangeline	Addilyn
Jordan	Erin
Paris	Alison
Olive	Ainsley
Ayla	Raelyn
Rosalie	Cadence
Kali	Kendra
Maci	Heidi
Gemma	Kelsey
Lilliana	Nadia
Raegan	Alondra
Lena	Cheyenne
Adelaide	Kaydence
Journey	Mikayla
Adelynn	River
Alessandra	Heaven
Kenzie	Arielle
Miranda	Lana
Haley	Blakely
June	Sabrina
Harley	Kyla
Charlee	Ada
Lucille	Gracelyn
Talia	Allyson
Skyler	Felicity
Makenna	Kira
Phoebe	Cameron
Jane	Josiah
Lyric	Adrian
Angel	Colton
Elaina	Jordan
Adrianna	Brayden
Ruth	Nicholas
Miriam	Robert
Diana	Angel
Mariana	Hudson
Danielle	Lincoln
Jenna	Evan
Shelby	Dominic
Nina	Austin
Madeleine	Gavin
Elliana	Nolan
Amina	Parker
Amiyah	Adam
Chelsea	Chase
Joanna	Jace
Jada	Ian
Lexi	Cooper
Katie	Easton
Maddison	Kevin
Fatima	Jose
Vera	Tyler
Malia	Brandon
Lilah	Asher
Madilyn	Jaxson
Amanda	Mateo
Daniella	Jason
Alexia	Ayden
Kathryn	Zachary
Paislee	Carson
Selena	Xavier
Laura	Leo
Annie	Ezra
Nyla	Bentley
Catalina	Sawyer
Kayleigh	Kayden
Sloane	Blake
Kamila	Nathaniel
Lia	Ryder
Haven	Sloane
Rowan	Kamila
Ashlyn	Lia
Christina	Haven
Amber	Rowan
Myla	Ashlyn
Addilyn	Christina
Erin	Amber
Alison	Myla
Ainsley	Addilyn
Raelyn	Erin
Cadence	Alison
Kendra	Ainsley
Heidi	Raelyn
Kelsey	Cadence
Nadia	Kendra
Alondra	Heidi
Cheyenne	Kelsey
Kaydence	Nadia
Mikayla	Alondra
River	Cheyenne
Heaven	Kaydence
Arielle	Mikayla
Lana	River
Blakely	Heaven
Sabrina	Arielle
Kyla	Lana
Ada	Blakely
Gracelyn	Sabrina
Allyson	Kyla
Felicity	Ada
Kira	Gracelyn
Cameron	Allyson
Josiah	Felicity
Adrian	Kira
Colton	Cameron
Jordan	Josiah
Brayden	Adrian
Nicholas	Colton
Robert	Jordan
Angel	Brayden
Hudson	Nicholas
Lincoln	Robert
Evan	Angel
Dominic	Hudson
Austin	Lincoln
Gavin	Evan
Nolan	Dominic
Parker	Austin
Adam	Gavin
Chase	Nolan
Jace	Parker
Ian	Adam
Cooper	Chase
Easton	Jace
Kevin	Ian
Jose	Cooper
Tyler	Easton
Brandon	Kevin
Asher	Jose
Jaxson	Tyler
Mateo	Brandon
Jason	Asher
Ayden	Jaxson
Zachary	Mateo
Carson	Jason
Xavier	Ayden
Leo	Zachary
Ezra	Carson
Bentley	Xavier
Sawyer	Leo
Kayden	Ezra
Blake	Bentley
Nathaniel	Sawyer
Ryder	Kayden
Theodore	Blake
Elias	Nathaniel
Tristan	Ryder
Roman	Sloane
Leonardo	Kamila
Camden	Lia
Brody	Haven
Luis	Rowan
Miles	Ashlyn
Micah	Christina
Vincent	Amber
Justin	Myla
Greyson	Addilyn
Declan	Erin
Maxwell	Alison
Juan	Ainsley
Cole	Raelyn
Damian	Cadence
Carlos	Kendra
Max	Heidi
Harrison	Kelsey
Weston	Nadia
Brantley	Alondra
Braxton	Cheyenne
Axel	Kaydence
Diego	Mikayla
Abel	River
Wesley	Heaven
Santiago	Arielle
Jesus	Lana
Silas	Blakely
Giovanni	Sabrina
Bryce	Kyla
Jayce	Ada
Bryson	Gracelyn
Alex	Allyson
Everett	Felicity
George	Kira
Eric	Cameron
Ivan	Josiah
Emmett	Adrian
Kaiden	Colton
Ashton	Jordan
Kingston	Brayden
Jonah	Nicholas
Jameson	Robert
Kai	Angel
Maddox	Hudson
Timothy	Lincoln
Ezekiel	Evan
Ryker	Dominic
Emmanuel	Austin
Hayden	Gavin
Antonio	Nolan
Bennett	Parker
Steven	Adam
Richard	Chase
Jude	Jace
Luca	Ian
Edward	Cooper
Joel	Easton
Victor	Kevin
Miguel	Jose
Malachi	Tyler
King	Brandon
Patrick	Asher
Kaleb	Jaxson
Bryan	Mateo
Alan	Jason
Marcus	Ayden
Preston	Zachary
Abraham	Carson
Calvin	Xavier
Colin	Leo
Bradley	Ezra
Jeremy	Bentley
Kyle	Sawyer
Graham	Kayden
Grant	Blake
Jesse	Nathaniel
Kaden	Ryder
Alejandro	Nolan
Oscar	Parker
Jase	Adam
Karter	Chase
Maverick	Jace
Aidan	Ian
Tucker	Cooper
Avery	Easton
Amir	Kevin
Brian	Jose
Iker	Tyler
Matteo	Brandon
Caden	Asher
Zayden	Jaxson
Riley	Mateo
August	Jason
Mark	Nolan
Maximus	Parker
Brady	Adam
Kenneth	Chase
Paul	Jace
Jaden	Ian
Nicolas	Cooper
Beau	Easton
Dean	Kevin
Jake	Jose
Peter	Tyler
Xander	Brandon
Elliot	Asher
Finn	Nolan
Derek	Parker
Sean	Adam
Cayden	Chase
Elliott	Jace
Jax	Ian
Jasper	Cooper
Lorenzo	Easton
Omar	Kevin
Beckett	Jose
Rowan	Tyler
Gael	Brandon
Corbin	Asher
Waylon	Jaxson
Myles	Mateo
Tanner	Nolan
Jorge	Parker
Javier	Adam
Zion	Chase
Andres	Jace
Charlie	Ian
Paxton	Cooper
Emiliano	Easton
Brooks	Kevin
Zane	Jose
Simon	Tyler
Judah	Brandon
Griffin	Asher
Cody	Jaxson
Gunner	Mateo
Dawson	Jason
Israel	Nolan
Rylan	Parker
Gage	Adam
Messiah	Chase
River	Jace
Kameron	Ian
Stephen	Cooper
Francisco	Easton
Clayton	Kevin
Zander	Jose
Chance	Tyler
Eduardo	Brandon
Spencer	Asher
Lukas	Jaxson
Damien	Mateo
Dallas	Jason
Conner	Nolan
Travis	Parker
Knox	Adam
Raymond	Chase
Peyton	Jace
Devin	Ian
Felix	Cooper
Jayceon	Easton
Collin	Kevin
Amari	Jose
Erick	Tyler
Cash	Brandon
Jaiden	Asher
Fernando	Jaxson
Cristian	Mateo
Josue	Jason
Keegan	Nolan
Garrett	Parker
Rhett	Adam
Ricardo	Chase
Martin	Jace
Reid	Ian
Seth	Cooper
Andre	Easton
Cesar	Kevin
Titus	Jose
Donovan	Tyler
Manuel	Brandon
Mario	Asher
Caiden	Jaxson
Adriel	Mateo
Kyler	Jason
Milo	Titus
Archer	Donovan
Jeffrey	Manuel
Holden	Mario
Arthur	Caiden
Karson	Adriel
Rafael	Kyler
Shane	Milo
Lane	Archer
Louis	Jeffrey
Angelo	Holden
Remington	Arthur
Troy	Karson
Emerson	Rafael
Maximiliano	Shane
Hector	Lane
Emilio	Louis
Anderson	Angelo
Trevor	Remington
Phoenix	Troy
Walter	Emerson
Johnathan	Titus
Johnny	Donovan
Edwin	Manuel
Julius	Mario
Barrett	Caiden
Leon	Adriel
Tyson	Kyler
Tobias	Milo
Edgar	Archer
Dominick	Jeffrey
Marshall	Holden
Marco	Arthur
Joaquin	Karson
Dante	Rafael
Andy	Shane
Cruz	Lane
Ali	Louis
Finley	Angelo
Dalton	Remington
Gideon	Troy
Reed	Emerson
Enzo	Titus
Sergio	Donovan
Jett	Manuel
Thiago	Mario
Kyrie	Caiden
Ronan	Adriel
Cohen	Kyler
Colt	Milo
Erik	Archer
Trenton	Jeffrey
Jared	Holden
Walker	Arthur
Landen	Karson
Alexis	Rafael
Nash	Shane
Jaylen	Lane
Gregory	Louis
Emanuel	Angelo
Killian	Remington
Allen	Troy
Atticus	Emerson
Desmond	Titus
Shawn	Donovan
Grady	Manuel
Quinn	Mario
Frank	Caiden
Fabian	Adriel
Dakota	Kyler
Roberto	Milo
Beckham	Archer
Major	Jeffrey
Skyler	Holden
Nehemiah	Arthur
Drew	Karson
Cade	Rafael
Muhammad	Shane
Kendrick	Lane
Pedro	Louis
Orion	Angelo
Aden	Remington
Kamden	Troy
Ruben	Emerson
Zaiden	Titus
Clark	Donovan
Noel	Manuel
Porter	Mario
Solomon	Caiden
Romeo	Adriel
Rory	Kyler
Malik	Milo
Daxton	Archer
Leland	Jeffrey
Kash	Holden
Abram	Arthur
Derrick	Karson
Kade	Rafael
Gunnar	Shane
Prince	Lane
Brendan	Louis
Leonel	Angelo
Kason	Remington
Braylon	Troy
Legend	Emerson
Pablo	Titus
Jay	Donovan
Adan	Manuel
Jensen	Mario
Esteban	Caiden
Kellan	Adriel
Drake	Kyler
Warren	Milo
Ismael	Archer
Ari	Jeffrey
Russell	Holden
Bruce	Arthur
Finnegan	Karson
Marcos	Rafael
Jayson	Shane
Theo	Lane
Jaxton	Louis
Phillip	Angelo
Dexter	Remington
Braylen	Troy
Armando	Emerson
Braden	Titus
Corey	Donovan
Kolton	Manuel
Gerardo	Mario
Ace	Caiden
Ellis	Adriel
Malcolm	Kyler
Tate	Milo
Zachariah	Archer
Chandler	Jeffrey
Milan	Holden
Keith	Arthur
Danny	Karson
Damon	Rafael
Enrique	Shane
Jonas	Lane
Kane	Louis
Princeton	Angelo
Hugo	Remington
Ronald	Troy
Philip	Emerson
Ibrahim	Titus
Kayson	Donovan
Maximilian	Manuel
Lawson	Mario
Harvey	Caiden
Albert	Adriel
Donald	Kyler
Raul	Milo
Franklin	Archer
Hendrix	Jeffrey
Odin	Holden
Brennan	Arthur
Jamison	Karson
Dillon	Rafael
Brock	Shane
Landyn	Lane
Mohamed	Louis
Brycen	Angelo
Deacon	Remington
Colby	Troy
Alec	Emerson
Julio	Titus
Scott	Donovan
Matias	Manuel
Sullivan	Mario
Rodrigo	Caiden
Cason	Adriel
Taylor	Kyler
Rocco	Milo
Nico	Archer
Royal	Jeffrey
Pierce	Holden
Augustus	Arthur
Raiden	Karson
Kasen	Rafael
Benson	Shane
Moses	Lane
Cyrus	Louis
Raylan	Angelo
Davis	Remington
Khalil	Troy
Moises	Emerson
Conor	Titus
Nikolai	Donovan
Alijah	Manuel
Mathew	Mario
Keaton	Caiden
Francis	Adriel
Quentin	Kyler
Ty	Milo
Jaime	Archer
Ronin	Jeffrey
Kian	Holden
Lennox	Arthur
Malakai	Karson
Atlas	Rafael
Jerry	Shane
Ryland	Lane
Ahmed	Louis
Saul	Angelo
Sterling	Remington
Dennis	Troy
Lawrence	Emerson
Zayne	Titus
Bodhi	Donovan
Arjun	Manuel
Darius	Mario
Arlo	Caiden
Eden	Adriel
Tony	Kyler
Dustin	Milo
Kellen	Archer
Chris	Jeffrey
Mohammed	Holden
Nasir	Arthur
Omari	Karson
Kieran	Rafael
Nixon	Shane
Rhys	Lane
Armani	Louis
Arturo	Angelo
Bowen	Remington
Frederick	Troy
Callen	Emerson
Leonidas	Titus
Remy	Donovan
Wade	Manuel
Luka	Mario
Jakob	Caiden
Winston	Adriel
Justice	Kyler
Alonzo	Milo
Curtis	Archer
Aarav	Jeffrey
Gustavo	Holden
Royce	Arthur
Asa	Karson
Gannon	Rafael
Kyson	Shane
Hank	Lane
Izaiah	Louis
Roy	Angelo
Raphael	Remington
Luciano	Troy
Hayes	Emerson
Case	Titus
Darren	Donovan
Mohammad	Manuel
Otto	Mario
Adriel Phoenix
Olive	Natalia
Weston	Carlos
Layton	Caiden
Isaias	Adriel
Alberto	Kyler
Jamari	Milo
Colten	Archer
Dax	Jeffrey
Marvin	Holden
Casey	Arthur
Moshe	Karson
Johan	Rafael
Sam	Shane
Matthias	Lane
Larry	Louis
Trey	Angelo
Devon	Remington
Trent	Troy
Mauricio	Emerson
Mathias	Titus
Issac	Donovan
Dorian	Manuel
Gianni	Mario
Ahmad	Caiden
Nikolas	Adriel
Oakley	Kyler
Uriel	Milo
Lewis	Archer
Randy	Jeffrey
Cullen	Holden
Braydon	Arthur
Ezequiel	Karson
Reece	Rafael
Jimmy	Shane
Crosby	Lane
Soren	Louis
Uriah	Angelo
Roger	Remington
Nathanael	Troy
Emmitt	Emerson
Gary	Titus
Rayan	Donovan
Ricky	Manuel
Mitchell	Mario
Roland	Caiden
Alfredo	Adriel
Cannon	Kyler
Jalen	Milo
Tatum	Archer
Kobe	Jeffrey
Yusuf	Holden
Quinton	Arthur
Korbin	Karson
Brayan	Rafael
Joe	Shane
Byron	Lane
Ariel	Louis
Quincy	Angelo
Carl	Remington
Kristopher	Troy
Alvin	Emerson
Duke	Titus
Lance	Donovan
London	Manuel
Jasiah	Mario
Boston	Caiden
Santino	Adriel
Lennon	Kyler
Deandre	Milo
Madden	Archer
Talon	Jeffrey
Sylas	Holden
Orlando	Arthur
Hamza	Karson
Bo	Rafael
Aldo	Shane
Douglas	Lane
Tristen	Louis
Wilson	Angelo
Maurice	Remington
Samson	Troy
Cayson	Emerson
Bryant	Titus
Conrad	Donovan
Dane	Manuel
Julien	Mario
Sincere	Caiden
Noe	Adriel
Salvador	Kyler
Nelson	Milo
Edison	Archer
Ramon	Jeffrey
Lucian	Holden
Mekhi	Arthur
Niko	Karson
Ayaan	Rafael
Vihaan	Shane
Neil	Lane
Titan	Louis
Ernesto	Angelo
Brentley	Remington
Lionel	Troy
Zayn	Emerson
Dominik	Titus
Cassius	Donovan
Rowen	Manuel
Blaine	Mario
Sage	Caiden
Kelvin	Adriel
Jaxen	Kyler
Memphis	Milo
Leonard	Archer
Abdullah	Jeffrey
Jacoby	Holden
Allan	Arthur
Jagger	Karson
Yahir	Rafael
Forrest	Shane
Guillermo	Lane
Mack	Louis
Zechariah	Angelo
Harley	Remington
Terry	Troy
Kylan	Emerson
Fletcher	Titus
Rohan	Donovan
Eddie	Manuel
Bronson	Mario
Jefferson	Caiden
Rayden	Adriel
Terrance	Kyler
Marc	Milo
Morgan	Archer
Valentino	Jeffrey
Demetrius	Holden
Kristian	Arthur
Hezekiah	Karson
Lee	Rafael
Alessandro	Shane
Makai	Lane
Rex	Louis
Callum	Angelo
Kamari	Remington
Casen	Troy
Tripp	Emerson
Callan	Titus
Stanley	Donovan
Toby	Manuel
Elian	Mario
Langston	Caiden
Melvin	Adriel
Payton	Kyler
Flynn	Milo
Jamir	Archer
Kyree	Jeffrey
Aryan	Holden
Axton	Arthur
Azariah	Karson
Branson	Rafael
Reese	Shane
Adonis	Lane
Thaddeus	Louis
Zeke	Angelo
Tommy	Remington
Blaze	Troy
Carmelo	Emerson
Skylar	Titus
Arian	Donovan
Bruno	Manuel
Kaysen	Mario
Layne	Caiden
Ray	Adriel
Zain	Kyler
Crew	Milo
Jedidiah	Archer
Rodney	Jeffrey
Clay	Holden
Tomas	Arthur
Alden	Karson
Jadiel	Rafael
Harper	Shane
Ares	Lane
Cory	Louis
Brecken	Angelo
Chaim	Remington
Nickolas	Troy
Kareem	Emerson
Xzavier	Titus
Kaison	Donovan
Alonso	Manuel
Amos	Mario
Vicente	Caiden
Samir	Adriel
Yosef	Kyler
Jamal	Milo
Jon	Archer
Bobby	Jeffrey
Aron	Holden
Ben	Arthur
Ford	Karson
Brodie	Rafael
Cain	Shane
Finnley	Lane
Briggs	Louis
Davion	Titus
Kingsley	Donovan
Brett	Manuel
Wayne	Mario
Zackary	Caiden
Apollo	Adriel
Emery	Kyler
Joziah	Milo
Lucca	Archer
Bentlee	Jeffrey
Hassan	Holden
Westin	Arthur
Joey	Karson
Vance	Rafael
Marcelo	Shane
Axl	Lane
Jermaine	Louis
Chad	Angelo
Gerald	Remington
Kole	Titus
Dash	Donovan
Dayton	Manuel
Lachlan	Mario
Shaun	Caiden
Kody	Adriel
Ronnie	Kyler
Kolten	Milo
Marcel	Archer
Stetson	Jeffrey
Willie	Holden
Jeffery	Arthur
Brantlee	Karson
Elisha	Rafael
Maxim	Shane
Kendall	Lane
Harry	Louis
Leandro	Angelo
Aaden	Remington
Channing	Titus
Kohen	Donovan
Yousef	Manuel
Darian	Mario
Enoch	Caiden
Mayson	Adriel
Neymar	Kyler
Giovani	Milo
Alfonso	Archer
Duncan	Jeffrey
Anders	Holden
Braeden	Arthur
Dwayne	Karson
Keagan	Rafael
Felipe	Shane
Fisher	Lane
Stefan	Louis
Trace	Angelo
Aydin	Remington
Anson	Troy
Clyde	Titus
Blaise	Donovan
Canaan	Manuel
Maxton	Mario
Alexzander	Caiden
Billy	Adriel
Harold	Kyler
Baylor	Milo
Gordon	Archer
Rene	Jeffrey
Terrence	Holden
Vincenzo	Arthur
Kamdyn	Karson
Marlon	Rafael
Castiel	Shane
Lamar	Lane
Augustine	Louis
Jamie	Angelo
Eugene	Remington
Harlan	Titus
Kase	Donovan
Miller	Manuel
Van	Mario
Kolby	Caiden
Sonny	Adriel
Emory	Kyler
Junior	Milo
Graysen	Archer
Heath	Jeffrey
Rogelio	Holden
Will	Arthur
Amare	Karson
Ameer	Rafael
Camdyn	Shane
Jerome	Lane
Maison	Louis
Micheal	Angelo
Cristiano	Remington
Giancarlo	Troy
Henrik	Titus
Lochlan	Donovan
Bode	Manuel
Camron	Mario
Houston	Caiden
Otis	Adriel
Hugh	Kyler
Kannon	Milo
Konnor	Archer
Emmet	Jeffrey
Kamryn	Holden
Maximo	Arthur
Adrien	Karson
Cedric	Rafael
Dariel	Shane
Landry	Lane
Leighton	Louis
Magnus	Angelo
Draven	Remington
Javon	Titus
Marley	Donovan
Zavier	Manuel
Markus	Mario
Justus	Caiden
