Kennedy Thomas
Oliver	Thomas
Jayden	Aaron
Joseph	Eli
Gabriel	Connor
Samuel	Jeremiah
Carter	Lillian
Paisley	Kennedy
Anthony	Natalie
John	Hannah
Dylan	John
Dylan	Aria
Luke	Layla
Henry	Brooklyn
Andrew	Alexa
Isaac	Thomas
Christopher	Aaron
Joshua	Eli
Wyatt	Connor
Sebastian	Jeremiah
Owen	Lillian
Caleb	Natalie
Nathan	Hannah
Ryan	Aria
Jack	Layla
Hunter	Brooklyn
Levi	Alexa
Christian	Thomas
Jaxon	Aaron
Julian	Eli
Landon	Connor
Grayson	Jeremiah
Jonathan	Lillian
Isaiah	Natalie
Charles	Hannah
Thomas	Aria
Aaron	Layla
Eli	Brooklyn
Connor	Alexa
Jeremiah	Thomas
Lillian	Aaron
Natalie	Eli
Hannah	Connor
Aria	Jeremiah
Layla	Lillian
Brooklyn	Natalie
Alexa	Hannah
Zoe	Aria
Penelope	Layla
Riley	Brooklyn
Leah	Alexa
Audrey	Thomas
Savannah	Aaron
Allison	Eli
Samantha	Connor
Nora	Jeremiah
Skylar	Lillian
Camila	Natalie
Anna	Hannah
Paisley	Aria
Ariana	Layla
Ellie	Brooklyn
Aaliyah	Alexa
Claire	Oliver
Paisley Oliver
Jayden Paisley
Oliver Dylan
Jayden Dylan
Violet	Jayden
Stella	Joseph
Sadie	Gabriel
Mila	Samuel
Gabriella	Carter
Lucy	Anthony
Arianna	John
Dylan Isaac
Kennedy	Dylan
Sarah	Luke
Madelyn	Henry
Eleanor	Andrew
Paisley Violet
Violet	Dylan
Kaylee	Isaac
Caroline	Christopher
Hazel	Joshua
